          #################
          #               #
###########               ####
#    #                       #
#    #                    ####
#    #                    #
#    ######               #
#                         #
#                         #
#         g               #
###########################
