######  
#g  g## 
#    g##
#  r  g#
#      #
#g    g#
########
