######
#r   #
#   g#
#   g#
#    #
######
