######
#r   #
#   g#
#   B#
#   b#
#   g#
#    #
######
