######       
#r   #       
#    ##
#     #
#     #
#    ##
#    # 
###### 
