######
#r   #
#    #######
#          #
#    ###   #
#    # #####
#    #
######
