      ###
      #g#
  #####g#####
 ##         ##
##  # # # #  ##
#  ##     ##  #
# ##  # #  ## #
#     brb     #
####  ###  ####
   #########
