   ###
  ## # ####
 ##  ###  #
## b      #
#   rb #  #
### b###  #
  #  #gg  #
 ## ##g# ##
 #      ##
 #     ##
 #######
