#######
#  g  #
#     #
#     #######
#  b     r  #
#           #
#############
