    #####
   ## g #
  ## bg #
 ## b   #
## br ###
# b  ##
#gg ##
#   #
#####
