###############
#        #    #
#g      bgbr  #
#g    gbb     #
########      #
###############