           #####
          ##   #
          #    #
    ####  # b ##
    #  ####b b#
    #     b b #
   ## ## b b b#
   #  g#  b b #
   #  g#      #
##### #########
#gggg r  #
#gggg    #
##  ######
 ####
