############
#          #
# bbbggg b #
#    ggg br#
# bbbggg b #
#          #
############
