 #######
##     #
#  bbb #
#gggggg#
# bb b #
### r###
  ####
