#########
#g    ###
#     ###
#b  rb###
# #b   ##
#   ## ##
# gg   ##
#########