  ######
###    ###
#   g#   #
#  bgb # #
#  #B b  #  
# Bgg   ## 
# b#br  #
# Bgg  ##
#  #b ##
##    #
 ######
