######
# g b#
# b  #
# r  #
######
