######
# g  #
# r  #
# b  #
######
