        #####
        #g  #
#########   #
#  #        #
#  ####     #
#           #
#     g     #
#############
