#####
# g ##
# b  #
# r  #
######
